94,95,101,90,91,96,90,91,94,95,93,88,89,97,88,103,93,96,90,92,93,91,88,97,88,97,91,88,99,90,88,89,89,90,91,91,88,97,91,91,
100,83,88,97,92,92,96,102,100,83,88,99,90,93,91,93,88,102,88,102,88,86,90,101,90,92,98,90,93,88,89,97,94,95,92,101,97,92,92,101,
90,96,90,92,92,93,93,88,89,89,90,93,88,89,102,258,259,260,260,260,260,260,260,261,262,93,93,88,89,89,90,93,100,83,101,90,93,93,92,91,
88,102,91,93,93,258,259,260,260,260,260,260,260,260,260,263,0,11,37,30,35,26,15,0,264,260,260,260,260,260,260,260,260,261,262,88,99,90,93,98,
91,88,86,90,93,263,0,0,0,0,0,0,0,0,0,265,266,267,267,267,267,267,267,268,269,0,0,0,0,0,0,0,0,0,264,91,93,94,95,93,
98,90,96,90,92,263,0,0,0,0,0,0,0,0,0,0,0,0,0,0,0,0,0,0,0,0,0,0,0,0,0,0,0,0,264,101,97,100,83,91,
93,88,102,88,102,263,0,0,0,0,0,0,0,0,0,0,0,0,0,0,0,0,0,0,0,0,0,0,0,0,0,0,0,0,264,91,93,91,88,103,
88,89,89,90,91,263,0,0,0,0,0,0,285,283,283,283,283,283,286,0,0,0,0,0,0,0,0,0,0,0,0,0,0,0,264,92,88,103,91,93,
90,96,90,88,103,263,0,0,0,0,0,0,287,22,15,32,15,22,287,0,0,0,0,0,0,0,0,0,0,0,0,0,0,0,264,92,91,93,101,97,
88,102,91,91,93,263,0,0,0,0,0,0,282,283,283,283,283,283,284,0,0,0,0,0,0,0,0,0,0,0,0,0,0,0,264,93,101,89,90,93,
88,89,102,101,97,263,0,0,0,0,247,248,254,248,254,248,254,248,254,248,249,0,0,0,0,0,0,0,0,0,0,0,0,0,264,91,88,97,88,97,
91,88,99,90,93,263,0,0,0,0,252,1,252,2,252,3,252,4,252,5,252,0,0,0,0,0,0,0,0,0,0,0,0,0,264,98,90,92,91,92,
103,91,93,94,95,263,0,0,0,0,253,248,255,248,255,248,255,248,255,248,257,0,0,0,0,0,0,0,0,0,0,0,0,0,264,93,91,93,92,93,
93,92,91,100,83,263,0,0,0,0,252,6,252,7,252,8,252,9,252,10,252,0,0,0,0,0,0,0,0,0,0,0,0,0,264,96,102,88,102,91,
91,92,92,88,97,263,0,0,0,0,250,248,256,248,256,248,256,248,256,248,251,0,0,0,0,0,0,0,0,0,0,0,0,0,264,93,94,95,88,103,
92,93,101,90,92,263,0,0,0,0,0,0,0,0,0,0,0,0,0,0,0,0,0,0,0,0,0,0,0,0,0,0,0,0,264,91,100,83,91,93,
92,88,89,97,93,263,0,0,236,237,237,237,237,237,237,237,237,237,237,237,237,237,237,237,237,237,237,237,237,237,237,238,0,0,264,98,90,91,100,97,
93,94,95,93,91,263,0,0,241,0,0,0,0,24,11,23,15,0,0,29,13,25,28,15,0,0,22,32,22,0,0,241,0,0,264,93,88,86,90,93,
91,100,83,96,102,263,0,0,242,237,237,237,237,237,237,237,237,237,237,237,237,237,237,237,237,237,237,237,237,237,237,246,0,0,264,91,91,91,88,89,
101,97,91,93,91,263,0,0,241,0,2,0,0,0,0,0,0,0,0,0,0,0,0,0,0,0,0,0,0,0,0,241,0,0,264,92,92,101,97,91,
90,93,98,90,92,263,0,0,241,0,0,0,0,0,0,0,0,0,0,0,0,0,0,0,0,0,0,0,0,0,0,241,0,0,264,92,101,90,93,92,
96,90,93,91,92,263,0,0,241,0,3,0,0,0,0,0,0,0,0,0,0,0,0,0,0,0,0,0,0,0,0,241,0,0,264,93,91,91,88,102,
92,94,95,92,93,263,0,0,241,0,0,0,0,0,0,0,0,0,0,0,0,0,0,0,0,0,0,0,0,0,0,241,0,0,264,96,102,98,90,96,
93,100,83,101,90,263,0,0,241,0,4,0,0,0,0,0,0,0,0,0,0,0,0,0,0,0,0,0,0,0,0,241,0,0,264,93,91,93,88,102,
88,99,90,94,95,263,0,0,241,0,0,0,0,0,0,0,0,0,0,0,0,0,0,0,0,0,0,0,0,0,0,241,0,0,264,91,101,89,90,91,
91,93,91,100,83,263,0,0,239,237,237,237,237,237,237,237,237,237,237,237,237,237,237,237,237,237,237,237,237,237,237,240,0,0,264,101,97,94,95,92,
92,91,98,90,91,263,0,0,0,0,0,0,0,0,0,0,0,0,0,0,0,0,0,0,0,0,0,0,0,0,0,0,0,0,264,91,93,100,83,92,
92,92,93,96,102,263,0,0,0,0,0,0,0,0,0,0,0,0,0,0,0,0,0,0,0,0,0,0,0,0,0,0,0,0,264,92,91,88,97,93,
93,101,90,93,91,265,266,267,267,267,267,267,267,267,267,267,267,267,267,267,267,267,267,267,267,267,267,267,267,267,267,267,267,268,269,92,98,90,101,90,
88,89,89,90,101,97,96,90,91,96,89,90,88,97,88,99,90,88,89,89,90,88,97,94,95,96,90,91,88,89,89,90,88,99,90,93,93,88,89,89
